1111111111111111111111111111111111
1E1000000000000C00000C000000000001
101001010010000010100100X000010101
1010010X10101010001001000P00010101
100000000C00C0000000010000000001C1
1111111111111111111111111111111111